111111111111111111111
1000P000000000C000E01
1000A000000000C000E01
1000A000000000C000E01
10000000000000C000E01
1000A0000A0000C000E01
1000A000000000C000E01
1000A000000000C000E01
111111111111111111111
